8 8
3 5
1 1 1 1 1 1 1 1
1 1 0 0 0 0 3 1
1 1 0 1 1 1 3 1
1 1 0 1 0 0 0 1
1 3 0 1 0 5 0 1
1 1 0 0 0 1 3 1
1 0 0 1 3 0 1 1
1 1 1 1 1 1 1 1