7 8
4 6
1 1 1 1 1 1 1
1 3 1 5 3 3 1
1 3 1 1 3 3 1
1 0 1 1 1 0 1
1 0 0 1 0 0 1
1 0 0 0 0 0 1
1 0 0 1 0 0 1
1 1 1 1 1 1 1